###################
#            O    #
#       P         #
####            O #
##                #
###XXXXXX     XXX #
#      O          #
#                 #
###################
